27, 9, 1, 0, 54, 55, 54, 0, 1, 12, 38
10, 0, 1, 0, 1, 2, 1, 0, 1, 0, 12
0, 0, 1, 0, 1, 55, 1, 0, 1, 0, 0
0, 67, 1, 0, 1, 6, 1, 0, 1, 58, 0
67, 61, 1, 0, 1, 6, 1, 0, 1, 57, 58
1, 3, 1, 0, 1, 11, 1, 0, 1, 3, 1
0, 0, 0, 0, 1, 11, 1, 0, 0, 0, 0
1, 1, 1, 0, 1, 1, 1, 0, 1, 1, 1
9, 67, 2, 68, 68, 69, 68, 68, 2, 67, 10
1, 1, 1, 1, 1, 3, 1, 1, 1, 1, 1
13, 00, 0, 0, 0, 0, 0, 0, 0, 00, 14