0, 43, 0, 1, 0, 25, 0, 1, 0, 43, 0
2, 1, 2, 1, 0, 0, 0, 1, 2, 1, 2
0, 1, 0, 1, 1, 115, 1, 1, 0, 1, 0
0, 1, 44, 1, 48, 49, 48, 1, 44, 1, 0
42, 1, 11, 1, 9, 48, 9, 1, 11, 1, 42
42, 1, 11, 1, 1, 4, 1, 1, 11, 1, 42
41, 1, 0, 1, 46, 47, 46, 1, 0, 1, 41
0, 1, 0, 1, 10, 46, 10, 1, 0, 1, 0
0, 1, 0, 1, 1, 3, 1, 1, 0, 1, 0
00, 1, 0, 1, 6, 0, 6, 1, 0, 1, 00
13, 1, 0, 43, 0, 0, 0, 43, 0, 1, 14