0, 0, 0, 00, 14, 20, 13, 00, 0, 0, 0
0, 20, 20, 20, 20, 20, 20, 20, 20, 20, 0
0, 20, 20, 1, 1, 1, 1, 1, 20, 20, 0
0, 20, 1, 1, 26, 1, 27, 1, 1, 20, 0
0, 20, 1, 1, 9, 1, 9, 1, 1, 20, 0
0, 20, 1, 1, 10, 1, 10, 1, 1, 20, 0
0, 20, 20, 1, 0, 1, 0, 1, 20, 20, 0
0, 20, 20, 1, 2, 1, 2, 1, 20, 20, 0
0, 20, 20, 20, 0, 0, 0, 20, 20, 20, 0
0, 20, 20, 20, 20, 4, 20, 20, 20, 20, 0
0, 0, 0, 0, 0, 0, 0, 0, 0, 0, 0