20, 20, 20, 20, 20, 20, 20, 20, 20, 20, 20
20, 20, 0, 0, 20, 13, 20, 0, 0, 20, 20
20, 0, 0, 20, 20, 57, 20, 20, 0, 0, 20
20, 0, 0, 0, 20, 57, 20, 0, 0, 0, 20
20, 20, 0, 0, 0, 0, 0, 0, 0, 20, 20
20, 20, 0, 0, 0, 00, 0, 0, 0, 20, 20
20, 20, 20, 0, 0, 20, 0, 0, 20, 20, 20
20, 20, 20, 20, 15, 14, 15, 20, 20, 20, 20
20, 20, 20, 20, 20, 20, 20, 20, 20, 20, 20
20, 20, 20, 20, 20, 20, 20, 20, 20, 20, 20
20, 20, 20, 20, 20, 20, 20, 20, 20, 20, 20