12, 0, 20, 0, 0, 0, 9, 9, 9, 0, 58
20, 0, 3, 0, 20, 20, 20, 20, 20, 20, 0
20, 0, 20, 0, 58, 58, 58, 57, 20, 20, 9
20, 0, 20, 20, 20, 20, 20, 30, 20, 20, 9
20, 0, 39, 20, 20, 20, 20, 20, 20, 57, 0
304, 00, 3, 39, 20, 20, 203, 115, 59, 4, 20
20, 0, 39, 20, 20, 20, 20, 20, 20, 57, 0
20, 0, 20, 20, 20, 20, 20, 30, 20, 20, 9
20, 0, 20, 0, 58, 58, 58, 57, 20, 20, 9
20, 0, 3, 0, 20, 20, 20, 20, 20, 20, 0
12, 0, 20, 0, 0, 0, 9, 9, 9, 0, 58