30, 56, 1, 9, 1, 6, 51, 39, 1, 12, 12
56, 6, 1, 10, 1, 0, 6, 51, 1, 65, 12
6, 49, 3, 0, 3, 49, 0, 6, 1, 0, 65
0, 0, 1, 47, 1, 0, 0, 0, 1, 52, 0
1, 1, 1, 4, 1, 1, 1, 1, 1, 2, 1
0, 0, 64, 0, 6, 6, 6, 0, 64, 0, 0
0, 1, 1, 1, 1, 1, 1, 1, 1, 1, 1
0, 1, 48, 2, 48, 0, 0, 0, 0, 0, 1
0, 1, 2, 1, 2, 1, 1, 1, 1, 3, 1
0, 1, 48, 1, 0, 0, 1, 1, 0, 00, 1
0, 0, 0, 1, 13, 00, 2, 2, 0, 14, 1