35, 6, 0, 1, 1, 1, 0, 0, 0, 1, 0
6, 0, 66, 2, 0, 0, 0, 1, 0, 2, 56
1, 2, 1, 1, 0, 1, 1, 1, 0, 1, 6
0, 0, 0, 1, 0, 1, 00, 0, 0, 1, 6
0, 0, 0, 4, 0, 1, 14, 1, 0, 1, 11
1, 3, 1, 1, 0, 1, 1, 1, 0, 1, 1
9, 52, 10, 1, 60, 1, 13, 1, 0, 1, 11
1, 2, 1, 1, 0, 0, 00, 2, 0, 1, 6
56, 11, 56, 1, 1, 3, 1, 1, 0, 1, 6
7, 56, 11, 1, 65, 60, 65, 1, 0, 2, 56
73, 7, 56, 2, 12, 65, 12, 1, 0, 1, 0