4444000000000000000000000000000000000000
4444000000000000000000000000000000000000
4441111111111111111111322222222222300000
4444000000000333333301322222222222300000
0000000000000333333301322222222222300000
0000002222000000000001322222222222300000
0000002222000000000001322222222222300000
0000000000000000000001000000000000000000
0011111111000000000001000000000000000000
0010000001000000000001000000000000000000
0010333001000000000001111111111110000000
0010333001000000000000000000000010000000
0010333001110000000000000000000010000000
0010000000011111111111111111111110000000
0010000000000000000000000000000000000000
0011111111111111111111111100222222200000
0000000000000000000000000100333333300000
0011100000000000000000000100333333300000
0010111111111111111111111100222222200000
0010000000000000000000000000000000004444
0010000000044444444444444444444000004444
0011111110000000000000000000000000004444
0000000011111111111111111111111111111444
0000000000000000000000000000000000004444
0000000000000000000000000000000000000000
