12, 20, 20, 20, 20, 303, 20, 20, 20, 20, 12
0, 0, 0, 0, 0, 00, 0, 0, 0, 0, 0
20, 3, 20, 20, 36, 3, 36, 20, 20, 3, 20
0, 0, 0, 20, 20, 36, 20, 20, 0, 0, 0
0, 20, 58, 20, 20, 20, 20, 20, 58, 20, 0
0, 20, 58, 20, 20, 20, 20, 20, 58, 20, 0
11, 20, 58, 20, 20, 305, 20, 20, 58, 20, 11
11, 20, 57, 31, 20, 115, 20, 31, 57, 20, 11
11, 20, 20, 20, 20, 59, 20, 20, 20, 20, 11
0, 20, 20, 20, 57, 4, 57, 20, 20, 20, 0
58, 0, 12, 12, 0, 20, 0, 12, 12, 0, 58